444444444444
412332111114
411233211114
411112333214
411111222114
444444444444
