444444444444444444444444444444444444444444444444444444444444444444444444444444444444444444444444444444444444444444444444
412332111111111111111111111111111111111111144444444444444444444444444444444444444444444444444444444444444444444444444444
411233211111111111111111111111111111111111144444444444444444444444444444444444444444444444444444444444444444444444444444
411112333211111111111111111111111111111111144444444444444444444444444444444444444444444444444444444444444444444444444444
411111222111111111111111111111111111111111144444444444444444444444444444444444444444444444444444444444444444444444444444
411111111111111111111111111111111111111111144444444444444444444444444444444444444444444444444444444444444444444444444444
411111111111111111111111111111111111111111144444444444444444444444444444444444444444444444444444444444444444444444444444
411111111111111111111111111111111111111111144444444444444444444444444444444444444444444444444444444444444444444444444444
411111111111111111111111111111111111111111144444444444444444444444444444444444444444444444444444444444444444444444444444
411111111111111111111111111111111111111111144444444444444444444444444444444444444444444444444444444444444444444444444444
411111111111111111111111111111111111111111144444444444444444444444444444444444444444444444444444444444444444444444444444
411111111111111111111111111111111111111111144444444444444444444444444444444444444444444444444444444444444444444444444444
411111111111111111111111111111111111111111144444444444444444444444444444444444444444444444444444444444444444444444444444
444444444444444444444444444444444444444444444444444444444444444444444444444444444444444444444444444444444444444444444444
444444444444444444444444444444444444444444444444444444444444444444444444444444444444444444444444444444444444444444444444
444444444444444444444444444444444444444444444444444444444444444444444444444444444444444444444444444444444444444444444444
444444444444444444444444444444444444444444444444444444444444444444444444444444444444444444444444444444444444444444444444
444444444444444444444444444444444444444444444444444444444444444444444444444444444444444444444444444444444444444444444444
444444444444444444444444444444444444444444444444444444444444444444444444444444444444444444444444444444444444444444444444
444444444444444444444444444444444444444444444444444444444444444444444444444444444444444444444444444444444444444444444444
444444444444444444444444444444444444444444444444444444444444444444444444444444444444444444444444444444444444444444444444
